111111111111111111111111111111111111111111111111111111111111111111111111111324111111111111111111111111111111111111111111111111111111111111111111
111111111111130000200331110011111001111000200011111001110011130020420111111000000111110020110011110020110201111110010001113300011131111111111111
111111111111102033130001100111111001110204131011100010101011102010202011111000000011111002020011111011011111130000203331100100001111111111111111
111111111111130111111031100000002001100000000001110211100011110014500011110011100011110020000211110000000001100000000001130011111131111111111111
111111111111100200003001101110410101100000015101101012111101102000000001111111111131132300020031111101111011111100011011111100230011111111111111
111111111111111111113331140111020021120000000001100000000211120000200001130001120211130002000031110001000111112201000001113301003331111111111111
111111111111100001111111101001111111100000141111101002001111131000000011133002010011101111110111100200000111111111100111111111111111111111111111
101000010001401000110101101000110101101001110101101022310101101200020101100000000101100000003101101131001101100020002331130032020231111111111111
111111111111111111111111100000000111100011000111112111120111100142000111133020133111110111133111100011000111100200200111110000001111111111111111
